default	bibo:Document
book	bibo:Book
Video	bibo:Film
[DVD]	bibo:Film
[Άρθρο]	bibo:Article
[Ηχογράφηση]	bibo:AudioDocument
[Video]	bibo:Film
[Περιοδικό]	bibo:Magazine
περιοδικό	bibo:Magazine
περιοδικο	bibo:Magazine
[Έντυπα 16ος-1912]	bibo:Document
Videο	bibo:Film
[Γραφικά]	bibo:Image
[Εντυπα 16ος-1912]	bibo:Document
DVD	bibo:Film
[Εφημερίδα]	bibo:Newspaper
εφημερίδα	bibo:Newspaper
[DVD-BD]	bibo:Film
[cd-rom]	bibo:AudioVisualDocument
[games]	bibo:AudioVisualDocument
[Αρθρο]	bibo:Article
[Video-DVD]	bibo:Film
[Εκπαιδευτικό πακέτο]	owl:Thing
[DVD-ROM]	bibo:Film
επιτομή	bibo:Document
bergere	bibo:Document
CD-ROM	bibo:AudioVisualDocument
B.Traven	bibo:Document
αρθρο	bibo:Article
Περιοδικό	bibo:Magazine
[Blu-ray]	bibo:Film
[DVDBD]	bibo:Film
[BLUE RAY]	bibo:Film
[DVD BLUE RAY]	bibo:Film
[Αρθρο]	bibo:Article
[Τεχνολογικός Εξοπλισμός]	owl:Thing
[Εκπαιδευτικό πακέτο ρομποτικής]	owl:Thing
[cd]	bibo:AudioDocument
[Braille]	bibo:Document
cd	bibo:AudioDocument
[Επιτραπέζιο παιχνίδι]	owl:Thing
ημερολόγιο	owl:Thing